111 1
11111
1 1 1
1  11
11111
 1111
  111
   11
    1
